NO ./textures/wall1.xpm
SO ./textures/wall2.xpm
EA ./textures/wall3.xpm
WE ./textures/wall4.xpm

C 0,0,0
F 133,133,233

11111111111111111
10000000000S01111
10010100000001111
10000000000001111
10000000000001111
10001000000001111
10000000000000111
10000000000000111
10000000000000111
10000000000000111
10000000000000111
10000000000000111
10100000000001001
10100000000001001
10100000000001001
10100000000001001
10100000000001001
10100000000001001
10000000000000001
10000000000000001
11111111111111111